"filename", "language", "C++", "Markdown", "Draw.io", "comment", "blank", "total"
"d:\C++\tinySTL-comment\HashTable.h", "C++", 111, 0, 0, 18, 15, 144
"d:\C++\tinySTL-comment\RedBlackTree.h", "C++", 189, 0, 0, 24, 21, 234
"d:\C++\tinySTL-comment\deque.h", "C++", 108, 0, 0, 0, 19, 127
"d:\C++\tinySTL-comment\list.h", "C++", 186, 0, 0, 14, 20, 220
"d:\C++\tinySTL-comment\note\deque容器.md", "Markdown", 0, 321, 0, 0, 93, 414
"d:\C++\tinySTL-comment\note\map\test.cpp", "C++", 13, 0, 0, 5, 1, 19
"d:\C++\tinySTL-comment\note\moveSeg\const_left_ref.cpp", "C++", 74, 0, 0, 11, 11, 96
"d:\C++\tinySTL-comment\note\pic\rhtree..drawio", "Draw.io", 0, 0, 285, 0, 0, 285
"d:\C++\tinySTL-comment\note\rbtree_refer\rbtree.cpp", "C++", 165, 0, 0, 6, 27, 198
"d:\C++\tinySTL-comment\note\vector容器.md", "Markdown", 0, 336, 0, 0, 78, 414
"d:\C++\tinySTL-comment\note\哈希表.md", "Markdown", 0, 462, 0, 0, 125, 587
"d:\C++\tinySTL-comment\note\红黑树.md", "Markdown", 0, 2, 0, 0, 1, 3
"d:\C++\tinySTL-comment\test.cpp", "C++", 81, 0, 0, 3, 5, 89
"d:\C++\tinySTL-comment\vector.h", "C++", 126, 0, 0, 55, 6, 187
"Total", "-", 1053, 1121, 285, 136, 422, 3017