"filename", "language", "C++", "Markdown", "Draw.io", "comment", "blank", "total"
"d:\C++\tinySTL-comment\HashTable.h", "C++", 112, 0, 0, 18, 15, 145
"d:\C++\tinySTL-comment\RedBlackTree.h", "C++", 514, 0, 0, 109, 40, 663
"d:\C++\tinySTL-comment\deque.h", "C++", 108, 0, 0, 0, 19, 127
"d:\C++\tinySTL-comment\list.h", "C++", 186, 0, 0, 14, 20, 220
"d:\C++\tinySTL-comment\map.h", "C++", 46, 0, 0, 0, 9, 55
"d:\C++\tinySTL-comment\mutiset.h", "C++", 54, 0, 0, 4, 9, 67
"d:\C++\tinySTL-comment\note\deque容器.md", "Markdown", 0, 321, 0, 0, 93, 414
"d:\C++\tinySTL-comment\note\doc.md", "Markdown", 0, 1, 0, 0, 0, 1
"d:\C++\tinySTL-comment\note\map\test.cpp", "C++", 13, 0, 0, 5, 1, 19
"d:\C++\tinySTL-comment\note\moveSeg\const_left_ref.cpp", "C++", 74, 0, 0, 11, 11, 96
"d:\C++\tinySTL-comment\note\pic\rhtree..drawio", "Draw.io", 0, 0, 285, 0, 0, 285
"d:\C++\tinySTL-comment\note\rbtree_refer\rbtree.cpp", "C++", 443, 0, 0, 89, 56, 588
"d:\C++\tinySTL-comment\note\vector容器.md", "Markdown", 0, 336, 0, 0, 78, 414
"d:\C++\tinySTL-comment\note\哈希表.md", "Markdown", 0, 462, 0, 0, 125, 587
"d:\C++\tinySTL-comment\note\红黑树.md", "Markdown", 0, 232, 0, 0, 61, 293
"d:\C++\tinySTL-comment\set.h", "C++", 29, 0, 0, 0, 8, 37
"d:\C++\tinySTL-comment\test.cpp", "C++", 165, 0, 0, 10, 10, 185
"d:\C++\tinySTL-comment\unordered_set.h", "C++", 19, 0, 0, 1, 8, 28
"d:\C++\tinySTL-comment\vector.h", "C++", 126, 0, 0, 55, 6, 187
"Total", "-", 1889, 1352, 285, 316, 569, 4411